11111111111111111111111111111111
1P........C.1...S.......C111
1111.11111111.11111.11111111
1.S..1....C..1....1......111
1.1111.1111111.1111..111.111
1.1.........1.......1....11.1
1.1.11111.1.1.111111.11..111
1...1...1.1.1.......1....1
111.1.1.1.1.1111111...11111
1...1.1...1....1C...1...111
1.111.11111.11.1.111111.11
1.1.........1..1......1111
1.1.11111111.111.11111...111
1.1.....1.....1.....1....1111
1.1111.1.1111111.1111111.111111
1C..1C.1.......1......C..111111
111.111.11111111..111111111111
1....1.........1..1.....11111111
1.11111111111111.1.1.111.11111
1.....1.......C...1...1..1111
1.11111...11111...111....11111
1......1.C.........1...C.111111
111111.11111.1.111111.11111111
1....1...S...1......1....111111
1.1111111.11.1.111111.11111111
1.....C....1...........C.1111111
11111111111111111111111111111111