11111111111111111111111111111111
1P....1....C....1....1..1....11
1111.1111.11111.11111.111111.111
1....1C...1.....C....1.......11
1.11111.1111111.1111..11111.111
1.1S..........1S.......1....11.1
1.1.11111.1.1.111111.11..11111
1...1...1.1.1.......1....1...1
111.1.1.1.1.1111111...1111111
1...1.1...1....1C...1...11111
1.111.11111.11.1.111111.11..11
1.1.........1..1......11111..1
1.1.11111111.111.11111...11111
1.1.....1.....1.....1....11111
1.1111.1.1111111.1111111.111111
1C..1C.1.......1.........111111
111.111.11111111..111111111111
1....1.........1..1.....1111111
1.11111111111111.1.1.111.111111
1.....1.......C...1...1..111111
1.11111...11111...111....111111
1......1.C.........1.....111111
111111.11111.1.111111.111111111
1....1...S...1......1....111111
1.1111111.11.1.111111.111111111
1.....C....1.............111111
1111111111111111111111111111111